NO ./texture/no.xpm
SO ./texture/so.xpm
WE ./texture/we.xpm
EA ./texture/ea.xpm
F 0,167,170
C 0,          ,0

111111
1E0001
111111
