















NO ./texture/no.xpm





SO				     ./texture/so.xpm


WE ./texture/we.xpm				               

   EA                      ./texture/ea.xpm				



















F +26,085,000000000000000000000000000000000000000000000000000000000000000000000000000000000000000000000000000000000000000000000000000000000000000000000000000000000000000000000000000000000000000000000000000087





C 0   				    , 								167    ,                                                                                                                                                                                            170
11         
11         
 1         
 1111      
  11S1     
   1001    
    1001   
     1001  
      1001 
       1001
        11 
