
NO ./assets/bark.xpm
SO ./assets/brick.xpm
WE ./assets/rock.xpm
EA ./assets/tile.xpm

F 1,0,0
C 1,0,0

111111
10E001
111111