
NO ./assets/bark.xpm
SO ./assets/brick.xpm
WE ./assets/rock.xpm
EA ./assets/tile.xpm

F 1,0,0
C 1,0,0

111111
1E0001
111111