NO ./texture/no.xpm
SO ./texture/so.xpm
WE ./texture/we.xpm
EA ./texture/ea.xpm
F 143 ,  5,55
C 255,255,255
1111
1001
1E01
1111