
NO ./assets/bark.xpm
SO ./assets/brick.xpm
WE ./assets/rock.xpm
EA ./assets/tile.xpmm

F 1,0,0
C 1,0,0

111111
10W001
111111