NO ./texture/no.xpm
SO ./texture/so.xpm
WE ./texture/we.xpm
EA ./texture/ea.xpm
F  0a,0,0
C 0,167,170

111111
1E0001
111111
