NO ./texture/no.xpm
SO ./texture/so.xpm
WE ./texture/we.xpm
EA ./texture/ea.xpm

F 26,85,87
C 0,167,170

11111111111111111111
