NO ./texture/no.xpm



WE ./texture/we.xpm

EA ./texture/ea.xpm

F 252,241,153
C 255,255,255


SO ./texture/so.xpm

1111
10N10
1001
1111