NO ./assets/bark.xpm
WE ./assets/rock.xpm
EA ./assets/tile.xpm

F 252,241,153
C 255,255,255


SO ./assets/brick_big.xpm


111111
1E0001
111111