NO ./texture/bark_big.xpm
SO ./texture/brick_big.xpm
WE ./texture/rock_big.xpm
EA ./texture/tile_big.xpm

F 225,206,154
C 204,85,0


        1111111111111111111111111111111111111111111111111111111111111111111111111111111111111111111111111111111111111111111111111111111111111111111111111111111111111111111111111111111111111111111111111
        1000000000110000000000001
        1011000001110000000000001
        1001000000000000000000001
111111111011000001110000000000001
100000000011000001110111111111111
11110111111111011100000010001
11110111111111011101010010001
11000000110101011100000010001
1000000000000001100000010001
10000000000000001101010001001
10000000000000001101010001001
10000000000000001101010001001
10000000000000001101010001001
10000000000000001101010001001
10000000000000001101010001001
10000000000000001101010001001
10000000000000001101010001001
10000000000000001101010001001
10000000000000001101010001001
10000000000000001101010001001
10000000000000001101010001001
10000000000000001101010001001
10000000000000001101010001001
10000000000000001101010001001
10000000000000001101010001001
10000000000000001101010001001
10000000000000001101010001001
10000000000000001101010001001
11110111111111011101010010001
11000000110101011100000010001
1000000000000001100000010001
10000000000000001101010001001
10000000000000001101010001001
10000000000000001101010001001
10000000000000001101010001001
10000000000000001101010001001
10000000000000001101010001001
10000000000000001101010001001
10000000000000001101010001001
10000000000000001101010001001
10000000000000001101010001001
10000000000000001101010001001
10000000000000001101010001001
10000000000000001101010001001
10000000000000001101010001001
10000000000000001101010001001
10000000000000001101010001001
10000000000000001101010001001
10000000000000001101010001001
10000000000000001101010001001
11110111111111011101010010001
11000000110101011100000010001
1000000000000001100000010001
10000000000000001101010001001
10000000000000001101010001001
10000000000000001101010001001
10000000000000001101010001001
10000000000000001101010001001
10000000000000001101010001001
10000000000000001101010001001
10000000000000001101010001001
10000000000000001101010001001
10000000000000001101010001001
10000000000000001101010001001
10000000000000001101010001001
10000000000000001101010001001
10000000000000001101010001001
10000000000000001101010001001
10000000000000001101010001001
10000000000000001101010001001
10000000000000001101010001001
10000000000000001101010001001
11110111111111011101010010001
11000000110101011100000010001
1000000000000001100000010001
10000000000000001101010001001
10000000000000001101010001001
10000000000000001101010001001
10000000000000001101010001001
10000000000000001101010001001
10000000000000001101010001001
10000000000000001101010001001
10000000000000001101010001001
10000000000000001101010001001
10000000000000001101010001001
10000000000000001101010001001
10000000000000001101010001001
10000000000000001101010001001
10000000000000001101010001001
10000000000000001101010001001
10000000000000001101010001001
10000000000000001101010001001
10000000000000001101010001001
10000000000000001101010001001
11110111111111011101010010001
11000000110101011100000010001
1000000000000001100000010001
10000000000000001101010001001
10000000000000001101010001001
10000000000000001101010001001
10000000000000001101010001001
10000000000000001101010001001
10000000000000001101010001001
10000000000000001101010001001
10000000000000001101010001001
10000000000000001101010001001
10000000000000001101010001001
10000000000000001101010001001
10000000000000001101010001001
10000000000000001101010001001
10000000000000001101010001001
10000000000000001101010001001
10000000000000001101010001001
10000000000000001101010001001
10000000000000001101010001001
10000000000000001101010001001
11110111111111011101010010001
11000000110101011100000010001
1000000000000001100000010001
10000000000000001101010001001
10000000000000001101010001001
10000000000000001101010001001
10000000000000001101010001001
10000000000000001101010001001
10000000000000001101010001001
10000000000000001101010001001
10000000000000001101010001001
10000000000000001101010001001
10000000000000001101010001001
10000000000000001101010001001
10000000000000001101010001001
10000000000000001101010001001
10000000000000001101010001001
10000000000000001101010001001
10000000000000001101010001001
10000000000000001101010001001
10000000000000001101010001001
1000000000000000110101000100111111111111111111111111111111
11110111111111011101010010001
11000000110101011100000010001
1000000000000001100000010001
10000000000000001101010001001
10000000000000001101010001001
10000000000000001101010001001
10000000000000001101010001001
10000000000000001101010001001
10000000000000001101010001001
10000000000000001101010001001
10000000000000001101010001001
10000000000000001101010001001
10000000000000001101010001001
10000000000000001101010001001
10000000000000001101010001001
10000000000000001101010001001
10000000000000001101010001001
10000000000000001101010001001
10000000000000001101010001001
10000000000000001101010001001
10000000000000001101010001001
1000000000000000110101000100111110111111111011101010010001
11000000110101011100000010001
1000000000000001100000010001
10000000000000001101010001001
10000000000000001101010001001
10000000000000001101010001001
10000000000000001101010001001
10000000000000001101010001001
10000000000000001101010001001
10000000000000001101010001001
10000000000000001101010001001
10000000000000001101010001001
10000000000000001101010001001
10000000000000001101010001001
10000000000000001101010001001
10000000000000001101010001001
10000000000000001101010001001
10000000000000001101010001001
10000000000000001101010001001
10000000000000001101010001001
10000000000000001101010001001
1000000000000000110101000100111110111111111011101010010001
11000000110101011100000010001
1000000000000001100000010001
10000000000000001101010001001
10000000000000001101010001001
10000000000000001101010001001
10000000000000001101010001001
10000000000000001101010001001
10000000000000001101010001001
10000000000000001101010001001
10000000000000001101010001001
10000000000000001101010001001
10000000000000001101010001001
10000000000000001101010001001
10000000000000001101010001001
10000000000000001101010001001
10000000000000001101010001001
10000000000000001101010001001
10000000000000001101010001001
10000000000000001101010001001
10000000000000001101010001001
1000000000000000110101000100111110111111111011101010010001
11000000110101011100000010001
1000000000000001100000010001
10000000000000001101010001001
10000000000000001101010001001
10000000000000001101010001001
10000000000000001101010001001
10000000000000001101010001001
10000000000000001101010001001
10000000000000001101010001001
10000000000000001101010001001
10000000000000001101010001001
10000000000000001101010001001
10000000000000001101010001001
10000000000000001101010001001
10000000000000001101010001001
10000000000000001101010001001
10000000000000001101010001001
10000000000000001101010001001
10000000000000001101010001001
10000000000000001101010001001
1000000000000000110101000100111110111111111011101010010001
11000000110101011100000010001
1000000000000001100000010001
10000000000000001101010001001
10000000000000001101010001001
10000000000000001101010001001
10000000000000001101010001001
10000000000000001101010001001
10000000000000001101010001001
10000000000000001101010001001
10000000000000001101010001001
10000000000000001101010001001
10000000000000001101010001001
10000000000000001101010001001
10000000000000001101010001001
10000000000000001101010001001
10000000000000001101010001001
10000000000000001101010001001
10000000000000001101010001001
10000000000000001101010001001
10000000000000001101010001001
1000000000000000110101000100111110111111111011101010010001
11000000110101011100000010001
1000000000000001100000010001
10000000000000001101010001001
10000000000000001101010001001
10000000000000001101010001001
10000000000000001101010001001
10000000000000001101010001001
10000000000000001101010001001
10000000000000001101010001001
10000000000000001101010001001
10000000000000001101010001001
10000000000000001101010001001
10000000000000001101010001001
10000000000000001101010001001
10000000000000001101010001001
10000000000000001101010001001
10000000000000001101010001001
10000000000000001101010001001
10000000000000001101010001001
10000000000000001101010001001
1000000000000000110101000100111110111111111011101010010001
11000000110101011100000010001
1000000000000001100000010001
10000000000000001101010001001
10000000000000001101010001001
10000000000000001101010001001
10000000000000001101010001001
10000000000000001101010001001
10000000000000001101010001001
10000000000000001101010001001
10000000000000001101010001001
10000000000000001101010001001
10000000000000001101010001001
10000000000000001101010001001
10000000000000001101010001001
10000000000000001101010001001
10000000000000001101010001001
10000000000000001101010001001
10000000000000001101010001001
10000000000000001101010001001
10000000000000001101010001001
1000000000000000110101000100111110111111111011101010010001
11000000110101011100000010001
1000000000000001100000010001
10000000000000001101010001001
10000000000000001101010001001
10000000000000001101010001001
10000000000000001101010001001
10000000000000001101010001001
10000000000000001101010001001
10000000000000001101010001001
10000000000000001101010001001
10000000000000001101010001001
10000000000000001101010001001
10000000000000001101010001001
10000000000000001101010001001
10000000000000001101010001001
10000000000000001101010001001
10000000000000001101010001001
10000000000000001101010001001
10000000000000001101010001001
10000000000000001101010001001
1000000000000000110101000100111110111111111011101010010001
11000000110101011100000010001
1000000000000001100000010001
10000000000000001101010001001
10000000000000001101010001001
10000000000000001101010001001
10000000000000001101010001001
10000000000000001101010001001
10000000000000001101010001001
10000000000000001101010001001
10000000000000001101010001001
10000000000000001101010001001
10000000000000001101010001001
10000000000000001101010001001
10000000000000001101010001001
10000000000000001101010001001
10000000000000001101010001001
10000000000000001101010001001
10000000000000001101010001001
10000000000000001101010001001
10000000000000001101010001001
1000000000000000110101000100111110111111111011101010010001
11000000110101011100000010001
1000000000000001100000010001
10000000000000001101010001001
10000000000000001101010001001
10000000000000001101010001001
10000000000000001101010001001
10000000000000001101010001001
10000000000000001101010001001
10000000000000001101010001001
10000000000000001101010001001
10000000000000001101010001001
10000000000000001101010001001
10000000000000001101010001001
10000000000000001101010001001
10000000000000001101010001001
10000000000000001101010001001
10000000000000001101010001001
10000000000000001101010001001
10000000000000001101010001001
10000000000000001101010001001
10000000000000001101010001001
11111111111111111111111111111111111111111111111111111111111111111111111111111111111111111111111111111111111111111111