NO ./assets/bark.xpm
SO ./assets/brick.xpm
WE ./assets/rock.xpm
EA ./assets/tile.xpm
F 0220,00100,0000000000
C 0,167,170

111111
1E0001
111111
