NO ./assets/bark.xpm
SO ./assets/brick.xpm
WE ./assets/rock.xpm
EA ./assets/tile.xpm

F 26,85,87
C 0,167,170

            11111111111111111111       
            10000000000000000001                    
            11111000000000001111
                1001100000000001
            11111000000011001111
            10000000000011000001
            10000000000000000001
            10000000000000000001
11111111111111111111111000000001
            10000000001000000001
            10000000001000000001
            10000000001000000001
            10000000001000000001
            10000000001000000001
            10000000001000000001
            10000000000000000001
            11111111111111111101
                             101
            111111111111111111N1
            11111111111111111111
