NO ./texture/no.xpm
WE ./texture/we.xpm
EA ./texture/ea.xpm
SO ./texture/so.xpm

F 225,206,154
C 204,85,0


        111111
        100E01
        11111
       