NO ./assets/bark_big.xpm
SO ./assets/brick_big.xpm
WE ./assets/rock_big.xpm
EA ./assets/tile_big.xpm

F 255,255,255
C 255,255,255

1111111111111111111111111
1000000000000000000000001
1000000000000000000000001
1111111111000000000000001
100000000100000000000001
1000000000000000000000001
111111111100010000010011
1000000001000100011110001
1000000001000100000010111
1000000001000100000011111
1100111111000100001111111
1100000000000100011000001
11000000000001N0011000001
1111111111111111111111111