NO ./assets/bark.xpm
SO ./assets/brick.xpm
WE ./assets/rock.xpm
EA ./assets/tile.xpm

F 55,71,79
C 236,239,241
1111111111111111111111111
1000000000000000000000001
1000000000000000000000001
1111111111000000000000001
100000000100000000000001
1000000000000000000000001
111111111100010000010011
1000000001000100011110001
1000000001000100000010001
1000000001000100000010001
1100111111000100001111111
1100000000000100001000001
11W0000000000100011000001
1111111111111111111111111