NO ./assets/bark.xpm
SO ./assets/brick.xpm
WE ./assets/rock.xpm
EA ./assets/tile.xpm

F 55,71,79
C 236,239,241
1111111111111111111111111
1000000000000000000000001
1000000000000000000000001
1111111111000000000000001
1000000001000000000000001
1000000000000000000000001
1111111111000100000010011
1000000001000100011110001
1000000001000100000010001
1000000001000100000010001
1100111111000100001011111
110000000000010O001000001
110000000000010N001000001
1111111111111111111111111