NO ./assets/bark.xpm
SO ./assets/brick.xpm
WE ./assets/rock.xpm
EA ./assets/tile.xpm

F 55,71,100
C 120,140,250

 1111
10N1
1111
1  1
1111
    1111
   1  1
 111111








