NO ./assets/bark.xpm
SO ./assets/brick.xpm
WE ./assets/rock.xpm
EA ./assets/tile.xpm

F 220,100,0
C 225,30,0


        1111111111111111111111111
        1000000000110000000000000
        1011000001110000000000001
        1001000000000000000000001
111111111011000001110000000000001
100000000011000001110111111111111
11110111111111011100000010001
11110111111111011101010010001
11000000110101011100000010001
1000000000000001100000010001
10000000000000001101010001001
1100000111010101111101111 10111
11110111 111N101 101111011001
11111111 1111111 111111111111









