NO ./path_to_the_north_texture
SO ./path_to_the_south_texture
WE ./path_to_the_west_texture
EA ./path_to_the_east_texture

F 220,100,0
C 225,30,0

1111111111111111111111111
1000000000110000000000001
1011000001110000000000001
1001000000000000000000001
1111111110110000000000001
1000000001110111111111111
1111111111011100000010001
1111011111111101010010001
1100000001011100000010001
1000000000001100000010001
1000000000001101010000001
11110101011111011110P0111
1111011100000101111010001
1111111111111111111111111