NO ./path_to_the_north_texture
SO ./path_to_the_south_texture
WE ./path_to_the_west_texture
EA ./path_to_the_east_texture

F 220,100,0
C 225,30,0
1111111111111111111111111
1000000000000000000000001
1000000000000000000000001
1111111111000000000000001
1000000001000000000000001
1000000000000000000000001
1111111111000100000010011
1000000001000100011110001
1000000001000100000010001
1000000001000100000010001
1100111111000100001011111
110000000000010P001000001
1100000000000100001000001
1111111111111111111111111