NO ./texture/no.xpm
SO ./texture/so.xpm
WE ./texture/we.xpm
EA ./texture/ea.xpm

F 0,0,0
C 255,255,255




1111111111111111111111111
1000000000000000000000001
1000000000000000000000001
1111111111000000000000001
10000000010000E000000011
1000000000000000000000001
111111111100010000010011
1000000001000100011110001
1000000001000100000010111
1000000001000100000011111
1100111111000100001111111
1100000000000100011000001
1100000000000100011000001
1111111111111111111111111