1111111
1000101
1001011
1111111