NO ./texture/bark_big.xpm
SO ./texture/brick_big.xpm
WE ./texture/rock_big.xpm
EA ./texture/tile_big.xpm

F 139,69,19

C 135,206, 250




1111111111111111111111111
1000000000000000000000001
1000000000000000000000001
1111111111000000000000001
100000000100000000000011
100000000000000000111111
111111111100010011
100000000100010001   1
100000000100010000111E111
1000000001000100000010111
1100111111000100000000111
1100000000000100011000001
1100000000000100011000001
1111111111111111111111111