NO ./texture/no.xpm
WE ./assets/we.xpm
EA ./assets/ea.xpm

F 85,107,47
C 173,216,230


SO ./assets/so.xpm


1111111111111111111111111
1000000000000000000000001
10S0000000000000000000001
1111111111000000000000001
100000000100000000000011
1000000000000000000011111
11111111110001000001    1
1000000001000100011111
1000000001000100000010111
1000000001000100000011111
1100111111000100001111111
1100000000000100011000001
1100000000000100011000001
1111111111111111111111111