NO ./assets/bark.xpm
SO ./assets/brick.xpm
WE ./assets/rock.xpm
EA ./assets/tile.xpm
F 0,167,170
C      220         ,100        ,                0

111111
1E0001
111111
