NO ./assets/bark.xpm
SO ./assets/brick.xpm
WE ./assets/rock.xpm
EA ./assets/tile.xpm

F 26,85,87
C 0,167,170

11111
10001
10S01
10001
11111
